{
  "width": 11,
  "height": 11,
  "cells": [
    0, 0, 0, 0, 2, 0, 2, 0, 0, 0, 0,
    8, 6, 8, 4, 9, 12, 5, 8, 4, 10, 4,
    0, 1, 0, 0, 2, 0, 2, 0, 0, 1, 0,
    0, 10, 4, 0, 9, 12, 5, 0, 8, 4, 0,
    0, 1, 8, 4, 0, 0, 0, 8, 4, 2, 0,
    0, 8, 4, 8, 12, 14, 12, 4, 8, 5, 0,
    8, 4, 0, 0, 0, 1, 0, 0, 0, 8, 4,
    8, 6, 8, 4, 10, 12, 6, 8, 4, 10, 4,
    0, 3, 2, 0, 1, 0, 1, 0, 2, 3, 0,
    8, 5, 1, 2, 8, 12, 4, 2, 1, 9, 4,
    0, 0, 0, 1, 0, 0, 0, 1, 0, 0, 0
  ]
}